###########E#######
##..........#.....#
#.#..#.......#....#
#....F.#.....#.#..#
#.#....#....#.##P##
#..###..#.....#...#
#.....P........#.##
#.#...#..#.#..F#P##
#.........#.#.....#
#...#......#.....F#
##....#...........#
#....#....##..#...#
#...P............##
#..#.#.#........#.#
#.##..#.#V#.#.....#
#.#..V.#.....V#...#
#....V.....F...V..#
#...#.#.V....##...#
#.F.#.....#..###..#
#.........#.......#
###########S#######
