################E##
#...#.##..#.......#
#.#....##.....#...#
#...............#.#
#.#..###..........#
#.................#
#......##.....#.#.#
#V...#...#.####P#.#
#......F..........#
##.........#...##.#
#..#............#.#
#........#...V#...#
#..V........F.....#
#.#....#..##.#....#
#.#...#..#........#
#...V..#V.......V.#
#.........#P.....P#
#......#..#......##
#.................#
#.....#......#....#
#S#################
