#######E###########
#......J......#..##
##F..#.#.........P#
###...P#........#.#
#...#..V....#....##
#...V...........#.#
#...#........F...##
#.....###......V.##
#...##....#.......#
#.......##.#..#.#.#
#..#..............#
#.................#
#..............#..#
#........F####....#
##.V..P.#.P...#...#
#.#..F.#.##..##...#
#..............F..#
#.................#
##......#..#...V..#
##.......V..#.....#
#################S#
